............
.#|..#.#|..#
............
..||....||..
|##..#|##..#
............
............
.#|..#.#|..#
............
..||....||..
|##..#|##..#
............